NO ./textures/north.xpm
SO ./textures/south.xpm
WE ./textures/east.xpm
EA ./textures/west.xpm
F 23,5,0
C 82,154,255

1111111111111111111111111
1N00000000000000000000001
1011000000000000000000001
1001000000000000000000001
1110000000000000011100001
10000000001111111111111111111111111
11110111111111011100000010001
11110111111111011101010010001
11000000110101011100000010001
10000000000000001100000010001
10000000000000001101010000001
1100000111010101111101111000111
111101111110101101111010001
1111111111111111111111111111
