NO ./textures/north.xpm
SO ./textures/south.xpm
WE ./textures/east.xpm
EA ./textures/west.xpm

F 23,5,0
C 82,154,255

11111111111111111111111111111111111
1N000000000000000000000000000000001
10110000000000000000000010000000001
10010000000000000000000010000000001
11100000000000000111000010000000001
10000000001111111111111111111111111
11110111111111011100000010001000001
11110111011111011101010010001000001
11000000110101011110000001000100001
10000000000000001100000010001000001
10000000000000001101010000001000001
11000001110101011111011110001110001
11110111111010110111101000110000001
11111111111111111111111111111111111
