NOd ./textures/north.xpm
SO ./textures/south.xpm
WE ./textures/east.xpm
EA ./textures/west.xpm
F 23,5,0
C 82,154,255

11111111111111111111111111
1N00000000000000000000001
1011000000000000000000001
1001000000000000000000001
1110000000000000011100001
10000000001111111111111111111111111
11110111111111011100000010001
11110111011111011101010010001
110000001101010111100000010001
10000000000000001100000010001
10000000000000001101010000001
1100000111010101111101111000111
1111011111101011011110100011
1111111111111111111111111111
